R 500 500
NO ./mur-rouge.xpm
SO ./tapi-rouge.xpm
WE ./tapi-symb.xpm
EA ./porte-shining5.xpm
S ./bananaal.xpm
F 220,51,100
C 225,30,0


11111111111111111111111111111
10000000001100000002000000001
10110200011102000020000010001
10010002000000020002000010001
10110000011100000000000010001
10000000001100000111011110001
11110111111111011100000010001
11110111111111011101010010001
11000000110101011100000010021
10000000000000001100000012001
10000000000000001101010012021
11000000110101011111011110N01
11110111111101011111011110021
11111111111111111111111111111